####################
#------------------#
#------------------#
#---------###------#
#------------------#
#----###-----------#
#------------------#
#------------------#
#######------------#
#------------------#
#-----------##-----#
#------------------#
#------------------#
#-----########-----#
#------------------#
#------------------#
#----------#########
#------------------#
#------------------#
####################