####################
#------------------#
#------------------#
#---------###------#
#------------------#
#------------------#
#------------------#
#------------------#
#------------------#
#------------------#
#------------------#
#------------------#
#------------------#
#-----########-----#
#------------------#
#------------------#
#------------------#
#------------------#
#------------------#
####################